########################################
#                    #                 #
#                    #                 #
#                    #                 #
#                    #        B        #
#                    #                 #
#                    #                 #
#                    #                 #
#                    #                 #
#                    #                 #
#                    #                 #
#                    #                 #
#         ####       #                 #
#            #       #                 #
#            #       #                 #
#            #                         #
#     A      #                         #
########################################